NO ./textures/north.png
SO ./textures/south.png
WE ./textures/west.png
EA ./textures/east.png

F 70,90,50
C 255,200,150

111111111111111111111111
100000000000000000000001
101111111111111111111101
100000000000E00000000001
101111111111111111111101
100000000000000000000001
111111111111111111111111
