NO ./textures/concrete.png
SO ./textures/grass.png
WE ./textures/sandstone.png
EA ./textures/marble.png

F 70,90,50
C 255,200,150

        111111111111111111111111
        100000000000000000000001
        101111111111111111111101
        100000000000N00000000001
        101111111111111111111101
        100000000000000000000001
        111111111111111111111111
