NO ./textures/pyramids.png
SO ./textures/pyramids.png
WE ./textures/pyramids.png
EA ./textures/pyramids.png

F 50,50,50
C 15,208,217

        1111111111111111111111111
        10N0000000110000000000001
        1011000001110000000000001
        1001000000000000000000001
111111111011000001110000000000001
100000000011000001110111111111111
111101111111110111000000100000000
111101111111110111010100100010000
110000001101010111000000100010000
100000000000000011000000100010000
10000000000000001101010010001
11000001110101011111011110001
11110111 1110101 101111010001
11111111 1111111 111111111111
