NO ./textures/pyramids.png
SO ./textures/pyramids.png
WE ./textures/pyramids.png
EA      ./textures/pyramids.png

F 254, 254, 222
F 255, 100, 0
C 0, 0, 0

        1111111111111111111111111
        1000000000110000000000001
        1011000001110000000000001
        10010000S0000000000000001
111111111011000001110000000000001
100000000011000101110111111111111
111101111111110111000000100000000
    111101111111110111010100100010000
110000001101010111000000100010000
100000000000000011000000100010000
10000000000000001101010010001
11000001110101011111011110001
11110111 1110101 101111010001
11111111 1111111 111111111111
