NO ./textures/163.png
SO ./textures/342.png
WE ./textures/377.png
EA ./textures/dalles2.png

F 60,40,20
C 200,100,50

        111111111111111111111111111
        100000000000000000000000001
        101111101111110111111011101
        100000101000000100001000001
        111110101011110111101111101
        100000101000N00100000000001
        111111111111111111111111111
