NO ./textures/377.png
SO ./textures/fire2.png
WE ./textures/t8.png
EA ./textures/342.png

F 20,20,20
C 80,120,180

        1111111111111111111111111
        1000000100000000000000001
        1011110101111101111111101
        1000010101000101000000001
        1111011101011101111111101
        100000000101000000000N001
        1111111111111111111111111
