NO ./textures/pyramids.png  
SO ./textures/pyramids.png  
WE ./textures/pyramids.png  
EA ./textures/pyramids.png  

F 30,30,40  
C 80,100,120  

111111111111111111111
100000000000000000001
10000000N000000000001
100000000000000000001
111010101110101011101
100000000000100000001
101110111110111110101
100010000000000010001
111111111111111111111
