NO ./textures/north.png
SO ./textures/south.png
WE ./textures/west.png
EA ./textures/east.png

F 50, 50, 100
C 15, 208, 217

        1111111111111111111111111
        10000N0000110000000000001
        1011000001110000000000001
        1001000000000000000000001
111111111011000001110000000000001
100000000011000001110111111111111
111101111111110111000000100010000
111101111111110111010100100010000
110000001101010111000000100010000
10000000000000001100000010001
10000000000000001101010010001
110000011101010111110111100011111
11110111 1110101 101111010001
11111111 1111111 111111111111
