NO ./textures/temple.png
SO ./textures/temple.png
WE ./textures/temple.png
EA ./textures/temple.png

F 20,20,20
C 200,200,200

111111111111111111111
100000000000000000001
100000000000000000001
100000000E00000000001
100000000000000000001
100000000000000000001
111111111111111111111