NO ./textures/t2.png
SO ./textures/t5.png
WE ./textures/t3.png
EA ./textures/temple.png

F 50,50,50
C 15,208,217

    1111111111111111111111         
   10000000000000000000001      
  1000000000000001000000001      
 1000000000000000000000001
1000000000000000000000001
 1000000000001000000000001
  1000000000000000000000001
   1000000000000000000000001
  1000100000000000000000001
 100000000000N000000000001
1111111111111111111111111
