NO ./textures/hills.png
SO ./textures/hills.png
WE ./textures/hills.png
EA ./textures/hills.png

F 30,30,30
C 100,150,200

11111111111111111111
10000000000000000001
10111011110111111001
10001010000100001001
11101011111110111001
100010000E0000000001
10111110111111111111
10000000100000000001
11111111111111111111
