NO ./textures/1.png
SO ./textures/2.png
WE ./textures/3.png
EA ./textures/4.png


F 70,90,50
C 255,200,150

111111111111111111111111
1E0000000000000000000001
111111111111111111111101
100000000000000000000001
101111111111111111111111
100000000000000000000001
111111111111111111111101
100000000000000000000001
101111111111111111111111
100000000000000000000001
111111111111111111111101
100000000000000000000001
101111111111111111111111
100000000000000000000001
111111111111111111111101
100000000000000000000001
101111111111111111111111
100000000000000000000001
111111111111111111111101
100000000000000000000001
101111111111111111111111
100000000000000000000001
111111111111111111111111
