NO ./textures/1.png
SO ./textures/2.png
WE ./textures/3.png
EA ./textures/4.png

F 40,60,30
C 120,180,90

        11111111111111111111111111111
        10000000000000000000000000001
        10111011111011111011111011101
        10001010001010001010001010001
        11101011101011101011101011101
        100010000010N0001000001000001
        11111111111111111111111111111
