NO ./textures/forest.png
SO ./textures/doom1.png
WE ./textures/temple.png
EA ./textures/stone_wall01.png

F 40,60,30
C 120,180,90

1111
10S1
1001
1001
1111