NO ./textures/smile.png
SO ./textures/smile.png
WE ./textures/smile.png
EA ./textures/smile.png

F 40,45,35
C 80,100,110

1111111111111111111111111
1N00001100000001100000001
1011100101111100101000101
1000100101000000101000101
1110111101110111101110111
1000000001000100001000001
1110111111110111101110111
1000100001000000001000101
1110111101110111101110111
1000000101000100001000001
1110111101110111101110111
1000100001000000000000101
1111101111110111111111101
1111111111111111111111111
