NO ./textures/north.png
SO ./textures/south.png
WE ./textures/west.png
EA ./textures/east.png

F 10, 20, 30
C 255,200,150

111111111111111111111111111111111111111111111111111111111111111111111111111111111111111111111111111111111111111111111111111111111111111111111111
1W0000000000000000000001
101111111111111111111101
100000000000000000000001
101111111111111111111101
100000000000000000000001
100000000000000000000001
101111111111111111111101
100000000000000000000001
101111111111111111111101
100000000000000000000001
101111111111111111111101
100000000000000000000001
101111111111111111111101
100000000000000000000001
100000000000000000000001
101111111111111111111101
100000000000000000000001
101111111111111111111101
100000000000000000000001
101111111111111111111101
100000000000000000000001
101111111111111111111101
100000000000000000000001
100000000000000000000001
101111111111111111111101
100000000000000000000001
101111111111111111111101
100000000000000000000001
101111111111111111111101
100000000000000000000001
101111111111111111111101
100000000000000000000001
100000000000000000000001
101111111111111111111101
100000000000000000000001
101111111111111111111101
100000000000000000000001
101111111111111111111101
100000000000000000000001
101111111111111111111101
100000000000000000000001
100000000000000000000001
101111111111111111111101
100000000000000000000001
101111111111111111111101
100000000000000000000001
101111111111111111111101
100000000000000000000001
101111111111111111111101
100000000000000000000001
100000000000000000000001
101111111111111111111101
100000000000000000000001
101111111111111111111101
100000000000000000000001
101111111111111111111101
100000000000000000000001
101111111111111111111101
100000000000000000000001
100000000000000000000001
101111111111111111111101
100000000000000000000001
101111111111111111111101
100000000000000000000001
101111111111111111111101
100000000000000000000001
101111111111111111111101
100000000000000000000001
100000000000000000000001
101111111111111111111101
100000000000000000000001
101111111111111111111101
100000000000000000000001
101111111111111111111101
100000000000000000000001
101111111111111111111101
100000000000000000000001
100000000000000000000001
101111111111111111111101
100000000000000000000001
101111111111111111111101
100000000000000000000001
101111111111111111111101
100000000000000000000001
101111111111111111111101
100000000000000000000001
100000000000000000000001
101111111111111111111101
100000000000000000000001
101111111111111111111101
100000000000000000000001
101111111111111111111101
100000000000000000000001
101111111111111111111101
100000000000000000000001
100000000000000000000001
101111111111111111111101
100000000000000000000001
101111111111111111111101
100000000000000000000001
101111111111111111111101
100000000000000000000001
101111111111111111111101
100000000000000000000001
100000000000000000000001
101111111111111111111101
100000000000000000000001
101111111111111111111101
100000000000000000000001
101111111111111111111101
100000000000000000000001
101111111111111111111101
100000000000000000000001
100000000000000000000001
101111111111111111111101
100000000000000000000001
101111111111111111111101
111111111111111111111111