NO ./textures/dalles2.png
SO ./textures/Tile_04-256x256.png
WE ./textures/Tile_20-256x256.png
EA ./textures/Woven_17-256x256.png

F 50,50,50
C 15,208,217

111111111
110000001
100000001
111101111
100000001
100N00001
111111111